Periodo,antivax: (Brasil),vacina causa autismo: (Brasil),anti-vacina: (Brasil),anti-vacinação: (Brasil),Soma,Popularidade,Ocorrencias
2009,0,0,100,0,100,20,1
2010,0,277,0,0,277,57,3
2011,0,33,0,0,33,7,3
2012,0,55,26,0,81,17,2
2013,0,22,0,23,45,9,7
2014,21,106,0,20,147,30,8
2015,37,120,0,0,157,32,8
2016,37,168,57,19,281,57,13
2017,34,130,69,34,267,54,12
2018,172,241,60,17,490,100,21